C 255,255,200
F 235,52,192





NO ./resources/grey-tile-portal.xpm



SO ./resources/marioquestion_1.xpm
WE ./resources/sky_1.xpm
EA ./resources/grass_1.xpm



11111111111111111111111111111
1000000000001111111Y111111111
11111111111111111111111111111