C 255,0,200
F 235,52,192
NO ./resources/grey-tile-portal.xpm
SO ./resources/marioquestion_1.xpm
WE ./resources/sky_1.xpm
EA ./resources/grass_1.xpm



1111111111111111111111111111111111111111111111111111111111111111111111111111111111111111111111111111
1111111111111110000000000000000000000000000000000000111111111111111111111111111111111111111111111111
1111111111111110000000000000000000000000000000000000111111111111111111111111111111111111111111111111
1111111111111110000000000000000000000000000000000000111111111111000000000000000000000000000000000001
1111111111111110000000000000000000000000000000000000111111111111000000000000000000000000000000000001
1111111111111110000000000000000000000000000000000000111111111111000000000000000000000000000000000001
1111000000001110000000000000000000000000000000000000111111111111000000000000000000000000000000000001
1111000000001110000000000000000000000000000000000000000000000000000000000000000000000000000000000001
1111000000001110000000000000000000000000000000000000111111111111000000000000000000000000000000000001
11100000S0000000000000000000000000000000000000000000111111111111000000000000000000000000000000000001
1110000000001110000000000000000000000000000000000000111111111111111111111111111111111111111111111111
1110000000001110000000000000000000000000000000000000111111111111111111111111111111111111111111111111
1110110111111110000000000000000000000000000000000000111111111111111111111111111111111111111111111111
1110110111111110000000000000000000000000000000000000111111111111111111111111111111111111111111111111
1110110111111111111111111111111111111111111111110111111111111111111111111111111111111111111111111111
1110110111111111111111111111111111111111111111110111111111111111111111111111111111111111111111111111
1110110111111111111111111111111111111111111111110111111111111111111111111111111111111111111111111111
1110110111111111111111111111111111111111111111110111111111111111111111111111111111111111111111111111
1110110111111111111111111111111111111111111111110111111111111111111111111111111111111111111111111111
1110110111111111111111111111111111111111111111110111111111111111111111111111111111111111111111111111
1110110111111111111111111111111111111111111111110111111111111111111111111111111111111111111111111111
1110110111111111111111111111111111111111111111110111111111111111111111111111111111111111111111111111
1110110111111111111111111111111111111111111111110111111111111111111111111111111111111111111111111111
1110110111111111111111111111111111111111111111110111111111111111111111111111111111111111111111111111
1110110111111111111111111111111111111111111111110111111111111111111111111111111111111111111111111111
1110110111111111111111111111111111111111111111110111111111111111111111111111111111111111111111111111
1110110111111111111111111111111111111111111111110111111111111111111111111111111111111111111111111111
1110110111111111111111111111111111111111111111110111111111111111111111111111111111111111111111111111
1000000000001111111111111111111111111111111111110111111111111111111111111111111111111111111111111111
1000000000001111111111111111111111111111111111110111111111111111111111111111111111111111111111111111
1000000000001111111111111111111111111111111111110111111111111111111111111111111111111111111111111111
1000000000001111111111111111111111111111111111110111111111111111111111111111111111111111111111111111
1000000000001111111111111111111111111111111111110111111111111111111111111111111111111111111111111111
1000000000001111111111111111111111111111111111110111111111111111111111111111111111111111111111111111
1000000000001111111111111111111111111111111111110111111111111111111111111111111111111111111111111111
1000000000001111111000000000000000000000000000000000000000000000000000000000001111111111111111111111
1000000000001111111000000000000000000000000000000000000000000000000000000000001111111111111111111111
1000000000001111111000000000000000000000000000000000000000000000000000000000001111111111111111111111
1000000000001111111000000000000000000000000000000000000000000000000000000000001111111111111111111111
1110111111111111111000000000000000000000000000000000000000000000000000000000001111111111111111111111
1110111111111111111000000000000000000000000000000000000000000000000000000000001111111111111111111111
1110111111111111111000000000000000000000000000000000000000000000000000000000001111111111111111111111
1110111111111111111000000000000000000000000000000000000000000000000000000000001111111111111111111111
1110111111111111111000000000000000000000000000000000000000000000000000000000001111111111111111111111
1110111111111111111000000000000000000000000000000000000000000000000000000000001111111111111111111111
1110111111111111111000000000000000000000000000000000000000000000000000000000001111111111111111111111
1110111111111111111000000000000000000000000000000000000000000000000000000000001111111111111111111111
1110111111111111111000000000000000000000000000000000000000000000000000000000001111111111111111111111
1110111111111111111000000000000000000000000000000000000000000000000000000000001111111111111111111111
1110111111111111111000000000000000000000000000000000000000000000000000000000001111111111111111111111
1110111111111111111000000000000000000000000000000000000000000000000000000000001111111111111111111111
1110111111111111111000000000000000000000000000000000000000000000000000000000001111111111111111111111
1110111111111111111000000000000000000000000000000000000000000000000000000000001111111111111111111111
1110111111111111111000000000000000000000000000000000000000000000000000000000000000000000011111111111
1110111111111111111000000000000000000000000000000000000000000000000000000000001111111111011111111111
1110111111111111111000000000000000000000000000000000000000000000000000000000001111111111011111111111
1110111111111111111000000000000000000000000000000000000000000000000000000000001000000000000000000011
1110111111111111111000000000000000000000000000000000000000000000000000000000001000000000000000000011
1110111111111111111000000000000000000000000000000000000000000000000000000000001000000000000000000011
1110111111111111111000000000000000000000000000000000000000000000000000000000001000000000000000000011
1110111111111111111000000000000000000000000000000000000000000000000000000000001000000000000000000011
1110111111111111111000000000000000000000000000000000000000000000000000000000001000000000000000000011
1110111111111111111000000000000000000000000000000000000000000000000000000000001000000000000000000011
1110111111111111111000000000000000000000000000000000000000000000000000000000001000000000000000000011
1110111111111111111000000000000000000000000000000000000000000000000000000000001000000000000000000011
1110111111111111111000000000000000000000000000000000000000000000000000000000001000000000000000000011
1110111111111111111000000000000000000000000000000000000000000000000000000000001000000000000000000011
1110111111111111111000000000000000000000000000000000000000000000000000000000001000000000000000000011
1110111111111111111000000000000000000000000000000000000000000000000000000000001000000000000000000011
1110111111111111111000000000000000000000000000000000000000000000000000000000001000000000000000000011
1110111111111111111000000000000000000000000000000000000000000000000000000000001000000000000000000011
1110111111111111111111111111111111111111111111111111111111111111111111111111111000000000000000000011
1110111111111111111111111111111111111111111111111111111111111111111111111111111000000000000000000011
1110111111111111111111111111111111111111111111111111111111111111111111111111111000000000000000000011
1110111111111111111111111111111111111111111111111111111111111111111111111111111000000000000000000011
1110111111111111111111111111111111111111111111111111111111111111111111111111111000000000000000000011
1110111111111111111111111111111111111111111111111111111111111111111111111111111000000000000000000011
1110111111111111111111111111111111111111111111111111111111111111111111111111111000000000000000000011
1110111111111111111111111111111111111111111111111111111111111111111111111111111000000000000000000011
1110111111111111111111111111111111111111111111111111111111111111111111111111111000000000000000000011
1110111111111111111111111111111111111111111111111111111111111111111111111111111000000000000000000011
1110111111111111111111111111111111111111111111111111111111111111111111111111111000000000000000000011
1110111111111111111111111111111111111111111111111111111111111111111111111111111000000000000000000011
1110111111111111111111111111111111111111111111111111111111111111111111111111111000000000000000000011
1110111111111111111111111111111111111111111111111111111111111111111111111111111000000000000000000011
1110111111111111111111111111111111111111111111111111111111111111111111111111111000000000000000000011
1110111111111111111111111111111111111111111111111111111111111111111111111111111000000000000000000011
1110111111111111111111111111111111111111111111111111111111111111111111111111111000000000000000000011
1110111111111111111111111111111111111111111111111111111111111111111111111111111000000000000000000011
1110111111111111111111111111111111111111111111111111111111111111111111111111111000000000000000000011
1110111111111111111111111111111111111111111111111111111111111111111111111111111000000000000000000011
1110111111111111111111111111111111111111111111111111111111111111111111111111111111111111111111111111
1110111111111111111111111111111111111111111111111111111111111111111111111111111111111111111111111111
1110111111111111111111111111111111111111111111111111111111111111111111111111111111111111111111111111
1000001100000011111111111111111111111111111111111111111111111111111111111111111111111111111111111111
1000001100000011111111111111111111111111111111111111111111111111111111111111111111111111111111111111
1000001100000011111111111111111111111111111111111111111111111111111111111111111111111111111111111111
1000000000000011111111111111111111111111111111111111111111111111111111111111111111111111111111111111
1000001100000011111111111111111111111111111111111111111111111111111111111111111111111111111111111111
1111111111111111111111111111111111111111111111111111111111111111111111111111111111111111111111111111
