
C 0,255,23

F 255,255,255

NO ./resources/grey-tile-portal.xpm
SO ./resources/marioquestion_1.xpm
WE ./resources/sky_1.xpm
EA ./resources/grass_1.xpm

11111111111111111111111111111111
10000000000000N000000000000001
1111111111111111111111111111111111
111111111111111111111111111111111
1111111111111111111111111111111
111111111111111111111111111111
