
C 255,55,255

F 255,255,255

NO ./resources/grey-tile-portal.xpm
SO ./resources/marioquestion_1.xpm
WE ./resources/sky_1.xpm
EA ./resources/grass_1.xpm

11111111111111111111111111111111
1       0000000000110000000000001
1       10110000011100P0        1
1       100P0000000P00000S0000001
111111111011000001110000000000001       1111
10000000001111P11111111111P111011       1001
11110101111111011100000010001101        1111
11110101111111011101010010001111
11000000110101011100000010001
10000000 00000001100000010001
10000000000000001101010010001
1100000111010101111101111000111
11110111 1110101 101111010001 
11111111 1111111 111111111111
